"filename", "language", "Python", "TOML", "Markdown", "MS SQL", "Ini", "comment", "blank", "total"
"c:\Users\sajit\AlgoRoyale\BUILD_PLAN.md", "Markdown", 0, 0, 108, 0, 0, 0, 41, 149
"c:\Users\sajit\AlgoRoyale\README.md", "Markdown", 0, 0, 26, 0, 0, 0, 19, 45
"c:\Users\sajit\AlgoRoyale\app_run.py", "Python", 12, 0, 0, 0, 0, 36, 9, 57
"c:\Users\sajit\AlgoRoyale\poetry.lock", "TOML", 0, 2197, 0, 0, 0, 1, 163, 2361
"c:\Users\sajit\AlgoRoyale\pyproject.toml", "TOML", 0, 42, 0, 0, 0, 130, 13, 185
"c:\Users\sajit\AlgoRoyale\scripts\add_file_headers.py", "Python", 68, 0, 0, 0, 0, 7, 16, 91
"c:\Users\sajit\AlgoRoyale\scripts\create_test_directory.py", "Python", 123, 0, 0, 0, 0, 33, 35, 191
"c:\Users\sajit\AlgoRoyale\scripts\import_helper.py", "Python", 49, 0, 0, 0, 0, 4, 13, 66
"c:\Users\sajit\AlgoRoyale\scripts\setup_database.py", "Python", 8, 0, 0, 0, 0, 4, 6, 18
"c:\Users\sajit\AlgoRoyale\src\algo_royale\adapters\account_cash_adapter.py", "Python", 12, 0, 0, 0, 0, 2, 6, 20
"c:\Users\sajit\AlgoRoyale\src\algo_royale\adapters\market_data\corporate_action_adapter.py", "Python", 48, 0, 0, 0, 0, 19, 10, 77
"c:\Users\sajit\AlgoRoyale\src\algo_royale\adapters\market_data\news_adapter.py", "Python", 37, 0, 0, 0, 0, 19, 9, 65
"c:\Users\sajit\AlgoRoyale\src\algo_royale\adapters\market_data\quote_adapter.py", "Python", 131, 0, 0, 0, 0, 124, 16, 271
"c:\Users\sajit\AlgoRoyale\src\algo_royale\adapters\market_data\screener_adapter.py", "Python", 22, 0, 0, 0, 0, 18, 8, 48
"c:\Users\sajit\AlgoRoyale\src\algo_royale\adapters\market_data\stream_adapter.py", "Python", 46, 0, 0, 0, 0, 48, 13, 107
"c:\Users\sajit\AlgoRoyale\src\algo_royale\adapters\trading\account_adapter.py", "Python", 96, 0, 0, 0, 0, 67, 11, 174
"c:\Users\sajit\AlgoRoyale\src\algo_royale\adapters\trading\assets_adapter.py", "Python", 29, 0, 0, 0, 0, 30, 11, 70
"c:\Users\sajit\AlgoRoyale\src\algo_royale\adapters\trading\calendar_adapter.py", "Python", 30, 0, 0, 0, 0, 31, 11, 72
"c:\Users\sajit\AlgoRoyale\src\algo_royale\adapters\trading\clock_adapter.py", "Python", 15, 0, 0, 0, 0, 13, 8, 36
"c:\Users\sajit\AlgoRoyale\src\algo_royale\adapters\trading\order_stream_adapter.py", "Python", 60, 0, 0, 0, 0, 47, 11, 118
"c:\Users\sajit\AlgoRoyale\src\algo_royale\adapters\trading\orders_adapter.py", "Python", 113, 0, 0, 0, 0, 88, 11, 212
"c:\Users\sajit\AlgoRoyale\src\algo_royale\adapters\trading\portfolio_adapter.py", "Python", 36, 0, 0, 0, 0, 10, 9, 55
"c:\Users\sajit\AlgoRoyale\src\algo_royale\adapters\trading\positions_adapter.py", "Python", 50, 0, 0, 0, 0, 37, 11, 98
"c:\Users\sajit\AlgoRoyale\src\algo_royale\adapters\trading\watchlist_adapter.py", "Python", 47, 0, 0, 0, 0, 98, 17, 162
"c:\Users\sajit\AlgoRoyale\src\algo_royale\application\market_data\market_data_enriched_streamer.py", "Python", 233, 0, 0, 0, 0, 56, 24, 313
"c:\Users\sajit\AlgoRoyale\src\algo_royale\application\market_data\market_data_raw_streamer.py", "Python", 190, 0, 0, 0, 0, 47, 22, 259
"c:\Users\sajit\AlgoRoyale\src\algo_royale\application\market_data\queued_async_enriched_data_buffer.py", "Python", 45, 0, 0, 0, 0, 2, 8, 55
"c:\Users\sajit\AlgoRoyale\src\algo_royale\application\orchestrator\trade_orchestrator.py", "Python", 0, 0, 0, 0, 0, 0, 1, 1
"c:\Users\sajit\AlgoRoyale\src\algo_royale\application\order_execution\order_execution.py", "Python", 13, 0, 0, 0, 0, 6, 3, 22
"c:\Users\sajit\AlgoRoyale\src\algo_royale\application\orders\equity_order_enums.py", "Python", 22, 0, 0, 0, 0, 12, 12, 46
"c:\Users\sajit\AlgoRoyale\src\algo_royale\application\orders\equity_order_types.py", "Python", 54, 0, 0, 0, 0, 125, 34, 213
"c:\Users\sajit\AlgoRoyale\src\algo_royale\application\orders\order_generator.py", "Python", 232, 0, 0, 0, 0, 53, 20, 305
"c:\Users\sajit\AlgoRoyale\src\algo_royale\application\orders\signal_order_payload.py", "Python", 7, 0, 0, 0, 0, 18, 5, 30
"c:\Users\sajit\AlgoRoyale\src\algo_royale\application\signals\queued_async_data_payload.py", "Python", 37, 0, 0, 0, 0, 19, 10, 66
"c:\Users\sajit\AlgoRoyale\src\algo_royale\application\signals\queued_async_symbol_list.py", "Python", 9, 0, 0, 0, 0, 7, 5, 21
"c:\Users\sajit\AlgoRoyale\src\algo_royale\application\signals\signal_generator.py", "Python", 206, 0, 0, 0, 0, 48, 20, 274
"c:\Users\sajit\AlgoRoyale\src\algo_royale\application\signals\signals_data_payload.py", "Python", 4, 0, 0, 0, 0, 18, 4, 26
"c:\Users\sajit\AlgoRoyale\src\algo_royale\application\signals\stream_data_ingest_object.py", "Python", 124, 0, 0, 0, 0, 37, 17, 178
"c:\Users\sajit\AlgoRoyale\src\algo_royale\application\signals\stream_signal_roster_object.py", "Python", 74, 0, 0, 0, 0, 45, 18, 137
"c:\Users\sajit\AlgoRoyale\src\algo_royale\application\strategies\portfolio_strategy_registry.py", "Python", 210, 0, 0, 0, 0, 7, 16, 233
"c:\Users\sajit\AlgoRoyale\src\algo_royale\application\strategies\signal_strategy_registry.py", "Python", 205, 0, 0, 0, 0, 15, 17, 237
"c:\Users\sajit\AlgoRoyale\src\algo_royale\application\symbols\enums.py", "Python", 9, 0, 0, 0, 0, 1, 3, 13
"c:\Users\sajit\AlgoRoyale\src\algo_royale\application\symbols\queued_async_symbol_hold.py", "Python", 10, 0, 0, 0, 0, 7, 5, 22
"c:\Users\sajit\AlgoRoyale\src\algo_royale\application\symbols\symbol_hold_tracker.py", "Python", 67, 0, 0, 0, 0, 4, 10, 81
"c:\Users\sajit\AlgoRoyale\src\algo_royale\application\utils\async_pubsub.py", "Python", 55, 0, 0, 0, 0, 1, 13, 69
"c:\Users\sajit\AlgoRoyale\src\algo_royale\application\utils\queued_async_update_object.py", "Python", 43, 0, 0, 0, 0, 17, 7, 67
"c:\Users\sajit\AlgoRoyale\src\algo_royale\backtester\backtest.py", "Python", 13, 0, 0, 0, 0, 2, 9, 24
"c:\Users\sajit\AlgoRoyale\src\algo_royale\backtester\column_names\base_column_names.py", "Python", 12, 0, 0, 0, 0, 7, 5, 24
"c:\Users\sajit\AlgoRoyale\src\algo_royale\backtester\column_names\column_name.py", "Python", 11, 0, 0, 0, 0, 3, 4, 18
"c:\Users\sajit\AlgoRoyale\src\algo_royale\backtester\column_names\data_ingest_columns.py", "Python", 12, 0, 0, 0, 0, 1, 4, 17
"c:\Users\sajit\AlgoRoyale\src\algo_royale\backtester\column_names\feature_engineering_columns.py", "Python", 288, 0, 0, 0, 0, 6, 5, 299
"c:\Users\sajit\AlgoRoyale\src\algo_royale\backtester\column_names\portfolio_evaluation_keys.py", "Python", 12, 0, 0, 0, 0, 2, 4, 18
"c:\Users\sajit\AlgoRoyale\src\algo_royale\backtester\column_names\portfolio_execution_keys.py", "Python", 27, 0, 0, 0, 0, 9, 9, 45
"c:\Users\sajit\AlgoRoyale\src\algo_royale\backtester\column_names\portfolio_strategy_columns.py", "Python", 7, 0, 0, 0, 0, 2, 7, 16
"c:\Users\sajit\AlgoRoyale\src\algo_royale\backtester\column_names\portfolio_transaction_keys.py", "Python", 12, 0, 0, 0, 0, 1, 2, 15
"c:\Users\sajit\AlgoRoyale\src\algo_royale\backtester\column_names\strategy_columns.py", "Python", 11, 0, 0, 0, 0, 2, 7, 20
"c:\Users\sajit\AlgoRoyale\src\algo_royale\backtester\data_preparer\asset_matrix_preparer.py", "Python", 55, 0, 0, 0, 0, 21, 9, 85
"c:\Users\sajit\AlgoRoyale\src\algo_royale\backtester\data_preparer\stage_data_preparer.py", "Python", 93, 0, 0, 0, 0, 14, 10, 117
"c:\Users\sajit\AlgoRoyale\src\algo_royale\backtester\enums\backtest_stage.py", "Python", 196, 0, 0, 0, 0, 35, 24, 255
"c:\Users\sajit\AlgoRoyale\src\algo_royale\backtester\enums\backtest_stage_dict_validation.py", "Python", 59, 0, 0, 0, 0, 28, 6, 93
"c:\Users\sajit\AlgoRoyale\src\algo_royale\backtester\enums\data_extension.py", "Python", 8, 0, 0, 0, 0, 10, 1, 19
"c:\Users\sajit\AlgoRoyale\src\algo_royale\backtester\enums\ma_type.py", "Python", 4, 0, 0, 0, 0, 7, 3, 14
"c:\Users\sajit\AlgoRoyale\src\algo_royale\backtester\enums\signal_type.py", "Python", 7, 0, 0, 0, 0, 17, 4, 28
"c:\Users\sajit\AlgoRoyale\src\algo_royale\backtester\evaluator\backtest\base_backtest_evaluator.py", "Python", 36, 0, 0, 0, 0, 4, 8, 48
"c:\Users\sajit\AlgoRoyale\src\algo_royale\backtester\evaluator\backtest\portfolio_backtest_evaluator.py", "Python", 239, 0, 0, 0, 0, 46, 15, 300
"c:\Users\sajit\AlgoRoyale\src\algo_royale\backtester\evaluator\backtest\signal_backtest_evaluator.py", "Python", 139, 0, 0, 0, 0, 10, 24, 173
"c:\Users\sajit\AlgoRoyale\src\algo_royale\backtester\evaluator\portfolio\portfolio_cross_strategy_summary.py", "Python", 62, 0, 0, 0, 0, 4, 9, 75
"c:\Users\sajit\AlgoRoyale\src\algo_royale\backtester\evaluator\portfolio\portfolio_cross_window_evaluator.py", "Python", 162, 0, 0, 0, 0, 12, 14, 188
"c:\Users\sajit\AlgoRoyale\src\algo_royale\backtester\evaluator\portfolio\portfolio_evaluation_coordinator.py", "Python", 40, 0, 0, 0, 0, 6, 7, 53
"c:\Users\sajit\AlgoRoyale\src\algo_royale\backtester\evaluator\strategy\signal_strategy_evaluation_coordinator.py", "Python", 175, 0, 0, 0, 0, 33, 25, 233
"c:\Users\sajit\AlgoRoyale\src\algo_royale\backtester\evaluator\strategy\strategy_evaluation_type.py", "Python", 4, 0, 0, 0, 0, 6, 2, 12
"c:\Users\sajit\AlgoRoyale\src\algo_royale\backtester\evaluator\strategy\strategy_evaluator.py", "Python", 99, 0, 0, 0, 0, 15, 12, 126
"c:\Users\sajit\AlgoRoyale\src\algo_royale\backtester\evaluator\symbol\symbol_evaluation_coordinator.py", "Python", 105, 0, 0, 0, 0, 26, 14, 145
"c:\Users\sajit\AlgoRoyale\src\algo_royale\backtester\executor\portfolio_backtest_executor.py", "Python", 419, 0, 0, 0, 0, 55, 35, 509
"c:\Users\sajit\AlgoRoyale\src\algo_royale\backtester\executor\strategy_backtest_executor.py", "Python", 239, 0, 0, 0, 0, 22, 33, 294
"c:\Users\sajit\AlgoRoyale\src\algo_royale\backtester\feature_engineering\backtest_feature_engineer.py", "Python", 106, 0, 0, 0, 0, 17, 15, 138
"c:\Users\sajit\AlgoRoyale\src\algo_royale\backtester\feature_engineering\feature_engineer.py", "Python", 648, 0, 0, 0, 0, 21, 57, 726
"c:\Users\sajit\AlgoRoyale\src\algo_royale\backtester\feature_engineering\feature_engineering.py", "Python", 216, 0, 0, 0, 0, 19, 30, 265
"c:\Users\sajit\AlgoRoyale\src\algo_royale\backtester\main.py", "Python", 13, 0, 0, 0, 0, 2, 9, 24
"c:\Users\sajit\AlgoRoyale\src\algo_royale\backtester\maps\condition_class_map.py", "Python", 171, 0, 0, 0, 0, 0, 2, 173
"c:\Users\sajit\AlgoRoyale\src\algo_royale\backtester\maps\portfolio_strategy_class_map.py", "Python", 42, 0, 0, 0, 0, 0, 2, 44
"c:\Users\sajit\AlgoRoyale\src\algo_royale\backtester\maps\portfolio_strategy_combinator_map.py", "Python", 42, 0, 0, 0, 0, 0, 2, 44
"c:\Users\sajit\AlgoRoyale\src\algo_royale\backtester\maps\signal_strategy_combinator_map.py", "Python", 69, 0, 0, 0, 0, 0, 2, 71
"c:\Users\sajit\AlgoRoyale\src\algo_royale\backtester\maps\stateful_logic_map.py", "Python", 17, 0, 0, 0, 0, 0, 2, 19
"c:\Users\sajit\AlgoRoyale\src\algo_royale\backtester\maps\strategy_class_map.py", "Python", 64, 0, 0, 0, 0, 6, 4, 74
"c:\Users\sajit\AlgoRoyale\src\algo_royale\backtester\optimizer\portfolio\optimization_direction.py", "Python", 4, 0, 0, 0, 0, 0, 3, 7
"c:\Users\sajit\AlgoRoyale\src\algo_royale\backtester\optimizer\portfolio\portfolio_metric.py", "Python", 5, 0, 0, 0, 0, 1, 3, 9
"c:\Users\sajit\AlgoRoyale\src\algo_royale\backtester\optimizer\portfolio\portfolio_strategy_optimizer.py", "Python", 268, 0, 0, 0, 0, 69, 21, 358
"c:\Users\sajit\AlgoRoyale\src\algo_royale\backtester\optimizer\portfolio\portfolio_strategy_optimizer_factory.py", "Python", 74, 0, 0, 0, 0, 54, 18, 146
"c:\Users\sajit\AlgoRoyale\src\algo_royale\backtester\optimizer\signal\signal_strategy_optimizer.py", "Python", 242, 0, 0, 0, 0, 64, 36, 342
"c:\Users\sajit\AlgoRoyale\src\algo_royale\backtester\optimizer\signal\signal_strategy_optimizer_factory.py", "Python", 62, 0, 0, 0, 0, 54, 18, 134
"c:\Users\sajit\AlgoRoyale\src\algo_royale\backtester\pipeline\pipeline_coordinator.py", "Python", 57, 0, 0, 0, 0, 12, 8, 77
"c:\Users\sajit\AlgoRoyale\src\algo_royale\backtester\stage_coordinator\data_staging\data_ingest_stage_coordinator.py", "Python", 179, 0, 0, 0, 0, 36, 27, 242
"c:\Users\sajit\AlgoRoyale\src\algo_royale\backtester\stage_coordinator\data_staging\feature_engineering_stage_coordinator.py", "Python", 135, 0, 0, 0, 0, 28, 19, 182
"c:\Users\sajit\AlgoRoyale\src\algo_royale\backtester\stage_coordinator\optimization\base_optimization_stage_coordinator.py", "Python", 151, 0, 0, 0, 0, 29, 16, 196
"c:\Users\sajit\AlgoRoyale\src\algo_royale\backtester\stage_coordinator\optimization\portfolio_optimization_stage_coordinator.py", "Python", 310, 0, 0, 0, 0, 93, 23, 426
"c:\Users\sajit\AlgoRoyale\src\algo_royale\backtester\stage_coordinator\optimization\signal_strategy_optimization_stage_coordinator.py", "Python", 338, 0, 0, 0, 0, 39, 26, 403
"c:\Users\sajit\AlgoRoyale\src\algo_royale\backtester\stage_coordinator\optimization\strategy_optimization_stage_coordinator.py", "Python", 0, 0, 0, 0, 0, 0, 1, 1
"c:\Users\sajit\AlgoRoyale\src\algo_royale\backtester\stage_coordinator\stage_coordinator.py", "Python", 5, 0, 0, 0, 0, 3, 3, 11
"c:\Users\sajit\AlgoRoyale\src\algo_royale\backtester\stage_coordinator\testing\base_testing_stage_coordinator.py", "Python", 149, 0, 0, 0, 0, 24, 14, 187
"c:\Users\sajit\AlgoRoyale\src\algo_royale\backtester\stage_coordinator\testing\portfolio_testing_stage_coordinator.py", "Python", 353, 0, 0, 0, 0, 36, 30, 419
"c:\Users\sajit\AlgoRoyale\src\algo_royale\backtester\stage_coordinator\testing\signal_strategy_testing_stage_coordinator.py", "Python", 437, 0, 0, 0, 0, 33, 33, 503
"c:\Users\sajit\AlgoRoyale\src\algo_royale\backtester\stage_data\loader\portfolio_matrix_loader.py", "Python", 357, 0, 0, 0, 0, 79, 28, 464
"c:\Users\sajit\AlgoRoyale\src\algo_royale\backtester\stage_data\loader\stage_data_loader.py", "Python", 291, 0, 0, 0, 0, 44, 28, 363
"c:\Users\sajit\AlgoRoyale\src\algo_royale\backtester\stage_data\loader\symbol_strategy_data_loader.py", "Python", 52, 0, 0, 0, 0, 11, 8, 71
"c:\Users\sajit\AlgoRoyale\src\algo_royale\backtester\stage_data\stage_data_manager.py", "Python", 361, 0, 0, 0, 0, 18, 24, 403
"c:\Users\sajit\AlgoRoyale\src\algo_royale\backtester\stage_data\writer\stage_data_writer.py", "Python", 92, 0, 0, 0, 0, 13, 13, 118
"c:\Users\sajit\AlgoRoyale\src\algo_royale\backtester\stage_data\writer\symbol_strategy_data_writer.py", "Python", 173, 0, 0, 0, 0, 14, 14, 201
"c:\Users\sajit\AlgoRoyale\src\algo_royale\backtester\stage_data_validation\portfolio_backtest_executor_validator.py", "Python", 75, 0, 0, 0, 0, 15, 5, 95
"c:\Users\sajit\AlgoRoyale\src\algo_royale\backtester\stage_data_validation\portfolio_evaluation_coordinator_validator.py", "Python", 165, 0, 0, 0, 0, 13, 5, 183
"c:\Users\sajit\AlgoRoyale\src\algo_royale\backtester\stage_data_validation\portfolio_optimization_stage_coordinator_validator.py", "Python", 81, 0, 0, 0, 0, 6, 3, 90
"c:\Users\sajit\AlgoRoyale\src\algo_royale\backtester\stage_data_validation\portfolio_testing_stage_coordinator_validator.py", "Python", 125, 0, 0, 0, 0, 44, 5, 174
"c:\Users\sajit\AlgoRoyale\src\algo_royale\backtester\stage_data_validation\signal_backtest_evaluator_validator.py", "Python", 16, 0, 0, 0, 0, 2, 6, 24
"c:\Users\sajit\AlgoRoyale\src\algo_royale\backtester\stage_data_validation\signal_strategy_evaluation_validator.py", "Python", 120, 0, 0, 0, 0, 9, 13, 142
"c:\Users\sajit\AlgoRoyale\src\algo_royale\backtester\stage_data_validation\signal_strategy_full_result_validator.py", "Python", 33, 0, 0, 0, 0, 11, 3, 47
"c:\Users\sajit\AlgoRoyale\src\algo_royale\backtester\stage_data_validation\signal_strategy_optimization_result_validator.py", "Python", 103, 0, 0, 0, 0, 13, 9, 125
"c:\Users\sajit\AlgoRoyale\src\algo_royale\backtester\stage_data_validation\signal_strategy_testing_result_validator.py", "Python", 79, 0, 0, 0, 0, 11, 13, 103
"c:\Users\sajit\AlgoRoyale\src\algo_royale\backtester\stage_data_validation\signal_summary_validator.py", "Python", 122, 0, 0, 0, 0, 10, 10, 142
"c:\Users\sajit\AlgoRoyale\src\algo_royale\backtester\stage_data_validation\validate_asyn_iterator_dict.py", "Python", 94, 0, 0, 0, 0, 15, 17, 126
"c:\Users\sajit\AlgoRoyale\src\algo_royale\backtester\strategy\base_strategy.py", "Python", 2, 0, 0, 0, 0, 4, 4, 10
"c:\Users\sajit\AlgoRoyale\src\algo_royale\backtester\strategy\portfolio\base_portfolio_strategy.py", "Python", 72, 0, 0, 0, 0, 28, 16, 116
"c:\Users\sajit\AlgoRoyale\src\algo_royale\backtester\strategy\portfolio\buffered_components\buffered_portfolio_strategy.py", "Python", 88, 0, 0, 0, 0, 57, 9, 154
"c:\Users\sajit\AlgoRoyale\src\algo_royale\backtester\strategy\portfolio\equal_risk_contribution_portfolio_strategy.py", "Python", 89, 0, 0, 0, 0, 17, 15, 121
"c:\Users\sajit\AlgoRoyale\src\algo_royale\backtester\strategy\portfolio\equal_weight_portfolio_strategy.py", "Python", 49, 0, 0, 0, 0, 42, 13, 104
"c:\Users\sajit\AlgoRoyale\src\algo_royale\backtester\strategy\portfolio\inverse_volatility_portfolio_strategy.py", "Python", 59, 0, 0, 0, 0, 15, 13, 87
"c:\Users\sajit\AlgoRoyale\src\algo_royale\backtester\strategy\portfolio\max_sharpe_portfolio_strategy.py", "Python", 86, 0, 0, 0, 0, 16, 14, 116
"c:\Users\sajit\AlgoRoyale\src\algo_royale\backtester\strategy\portfolio\mean_variance_portfolio_strategy.py", "Python", 86, 0, 0, 0, 0, 16, 14, 116
"c:\Users\sajit\AlgoRoyale\src\algo_royale\backtester\strategy\portfolio\minimum_variance_portfolio_strategy.py", "Python", 75, 0, 0, 0, 0, 15, 14, 104
"c:\Users\sajit\AlgoRoyale\src\algo_royale\backtester\strategy\portfolio\mock\mock_portfolio_strategy.py", "Python", 63, 0, 0, 0, 0, 76, 20, 159
"c:\Users\sajit\AlgoRoyale\src\algo_royale\backtester\strategy\portfolio\momentum_portfolio_strategy.py", "Python", 53, 0, 0, 0, 0, 23, 12, 88
"c:\Users\sajit\AlgoRoyale\src\algo_royale\backtester\strategy\portfolio\risk_parity_portfolio_strategy.py", "Python", 83, 0, 0, 0, 0, 25, 13, 121
"c:\Users\sajit\AlgoRoyale\src\algo_royale\backtester\strategy\portfolio\volatility_weighted_portfolio_strategy.py", "Python", 60, 0, 0, 0, 0, 23, 13, 96
"c:\Users\sajit\AlgoRoyale\src\algo_royale\backtester\strategy\portfolio\winner_takes_all_portfolio_strategy.py", "Python", 72, 0, 0, 0, 0, 17, 13, 102
"c:\Users\sajit\AlgoRoyale\src\algo_royale\backtester\strategy\signal\base_signal_strategy.py", "Python", 207, 0, 0, 0, 0, 45, 22, 274
"c:\Users\sajit\AlgoRoyale\src\algo_royale\backtester\strategy\signal\bollinger_bands_strategy.py", "Python", 27, 0, 0, 0, 0, 16, 4, 47
"c:\Users\sajit\AlgoRoyale\src\algo_royale\backtester\strategy\signal\buffered_components\buffered_condition.py", "Python", 27, 0, 0, 0, 0, 14, 7, 48
"c:\Users\sajit\AlgoRoyale\src\algo_royale\backtester\strategy\signal\buffered_components\buffered_signal_strategy.py", "Python", 103, 0, 0, 0, 0, 19, 11, 133
"c:\Users\sajit\AlgoRoyale\src\algo_royale\backtester\strategy\signal\buffered_components\buffered_stateful_logic.py", "Python", 36, 0, 0, 0, 0, 14, 7, 57
"c:\Users\sajit\AlgoRoyale\src\algo_royale\backtester\strategy\signal\combined_weighted_signal_strategy.py", "Python", 65, 0, 0, 0, 0, 19, 11, 95
"c:\Users\sajit\AlgoRoyale\src\algo_royale\backtester\strategy\signal\combo_strategy.py", "Python", 22, 0, 0, 0, 0, 10, 4, 36
"c:\Users\sajit\AlgoRoyale\src\algo_royale\backtester\strategy\signal\conditions\adx_above_threshold.py", "Python", 63, 0, 0, 0, 0, 30, 12, 105
"c:\Users\sajit\AlgoRoyale\src\algo_royale\backtester\strategy\signal\conditions\adx_below_threshold.py", "Python", 42, 0, 0, 0, 0, 29, 11, 82
"c:\Users\sajit\AlgoRoyale\src\algo_royale\backtester\strategy\signal\conditions\base_strategy_condition.py", "Python", 66, 0, 0, 0, 0, 29, 15, 110
"c:\Users\sajit\AlgoRoyale\src\algo_royale\backtester\strategy\signal\conditions\bollinger_bands_entry.py", "Python", 60, 0, 0, 0, 0, 4, 10, 74
"c:\Users\sajit\AlgoRoyale\src\algo_royale\backtester\strategy\signal\conditions\bollinger_bands_exit.py", "Python", 54, 0, 0, 0, 0, 0, 9, 63
"c:\Users\sajit\AlgoRoyale\src\algo_royale\backtester\strategy\signal\conditions\boolean_column_entry.py", "Python", 36, 0, 0, 0, 0, 3, 8, 47
"c:\Users\sajit\AlgoRoyale\src\algo_royale\backtester\strategy\signal\conditions\combo_entry.py", "Python", 84, 0, 0, 0, 0, 7, 9, 100
"c:\Users\sajit\AlgoRoyale\src\algo_royale\backtester\strategy\signal\conditions\combo_exit.py", "Python", 86, 0, 0, 0, 0, 7, 9, 102
"c:\Users\sajit\AlgoRoyale\src\algo_royale\backtester\strategy\signal\conditions\ema_above_sma_rolling.py", "Python", 55, 0, 0, 0, 0, 4, 11, 70
"c:\Users\sajit\AlgoRoyale\src\algo_royale\backtester\strategy\signal\conditions\macd_bearish_cross.py", "Python", 72, 0, 0, 0, 0, 31, 12, 115
"c:\Users\sajit\AlgoRoyale\src\algo_royale\backtester\strategy\signal\conditions\macd_bullish_cross.py", "Python", 84, 0, 0, 0, 0, 23, 12, 119
"c:\Users\sajit\AlgoRoyale\src\algo_royale\backtester\strategy\signal\conditions\momentum_entry.py", "Python", 83, 0, 0, 0, 0, 1, 9, 93
"c:\Users\sajit\AlgoRoyale\src\algo_royale\backtester\strategy\signal\conditions\momentum_exit.py", "Python", 83, 0, 0, 0, 0, 1, 9, 93
"c:\Users\sajit\AlgoRoyale\src\algo_royale\backtester\strategy\signal\conditions\moving_average_crossover_entry.py", "Python", 118, 0, 0, 0, 0, 18, 14, 150
"c:\Users\sajit\AlgoRoyale\src\algo_royale\backtester\strategy\signal\conditions\moving_average_crossover_exit.py", "Python", 112, 0, 0, 0, 0, 7, 14, 133
"c:\Users\sajit\AlgoRoyale\src\algo_royale\backtester\strategy\signal\conditions\moving_average_entry.py", "Python", 78, 0, 0, 0, 0, 13, 10, 101
"c:\Users\sajit\AlgoRoyale\src\algo_royale\backtester\strategy\signal\conditions\moving_average_exit.py", "Python", 72, 0, 0, 0, 0, 12, 10, 94
"c:\Users\sajit\AlgoRoyale\src\algo_royale\backtester\strategy\signal\conditions\price_above_sma.py", "Python", 90, 0, 0, 0, 0, 31, 12, 133
"c:\Users\sajit\AlgoRoyale\src\algo_royale\backtester\strategy\signal\conditions\price_below_sma.py", "Python", 89, 0, 0, 0, 0, 23, 12, 124
"c:\Users\sajit\AlgoRoyale\src\algo_royale\backtester\strategy\signal\conditions\price_crosses_above_sma.py", "Python", 77, 0, 0, 0, 0, 33, 12, 122
"c:\Users\sajit\AlgoRoyale\src\algo_royale\backtester\strategy\signal\conditions\price_crosses_below_sma.py", "Python", 77, 0, 0, 0, 0, 33, 12, 122
"c:\Users\sajit\AlgoRoyale\src\algo_royale\backtester\strategy\signal\conditions\pullback_entry.py", "Python", 79, 0, 0, 0, 0, 1, 9, 89
"c:\Users\sajit\AlgoRoyale\src\algo_royale\backtester\strategy\signal\conditions\pullback_exit.py", "Python", 45, 0, 0, 0, 0, 2, 11, 58
"c:\Users\sajit\AlgoRoyale\src\algo_royale\backtester\strategy\signal\conditions\return_volatility_exit.py", "Python", 73, 0, 0, 0, 0, 7, 9, 89
"c:\Users\sajit\AlgoRoyale\src\algo_royale\backtester\strategy\signal\conditions\rsi_above_threshold.py", "Python", 43, 0, 0, 0, 0, 31, 11, 85
"c:\Users\sajit\AlgoRoyale\src\algo_royale\backtester\strategy\signal\conditions\rsi_below_threshold.py", "Python", 60, 0, 0, 0, 0, 33, 11, 104
"c:\Users\sajit\AlgoRoyale\src\algo_royale\backtester\strategy\signal\conditions\rsi_entry.py", "Python", 57, 0, 0, 0, 0, 1, 9, 67
"c:\Users\sajit\AlgoRoyale\src\algo_royale\backtester\strategy\signal\conditions\rsi_exit.py", "Python", 57, 0, 0, 0, 0, 1, 9, 67
"c:\Users\sajit\AlgoRoyale\src\algo_royale\backtester\strategy\signal\conditions\sma_trend.py", "Python", 77, 0, 0, 0, 0, 11, 11, 99
"c:\Users\sajit\AlgoRoyale\src\algo_royale\backtester\strategy\signal\conditions\time_of_day_entry.py", "Python", 49, 0, 0, 0, 0, 0, 8, 57
"c:\Users\sajit\AlgoRoyale\src\algo_royale\backtester\strategy\signal\conditions\time_of_day_exit.py", "Python", 47, 0, 0, 0, 0, 0, 8, 55
"c:\Users\sajit\AlgoRoyale\src\algo_royale\backtester\strategy\signal\conditions\trailing_stop_exit_condition.py", "Python", 43, 0, 0, 0, 0, 6, 9, 58
"c:\Users\sajit\AlgoRoyale\src\algo_royale\backtester\strategy\signal\conditions\trend_above_sma.py", "Python", 67, 0, 0, 0, 0, 2, 9, 78
"c:\Users\sajit\AlgoRoyale\src\algo_royale\backtester\strategy\signal\conditions\volatility_breakout_entry.py", "Python", 121, 0, 0, 0, 0, 6, 10, 137
"c:\Users\sajit\AlgoRoyale\src\algo_royale\backtester\strategy\signal\conditions\volatility_breakout_exit.py", "Python", 118, 0, 0, 0, 0, 8, 10, 136
"c:\Users\sajit\AlgoRoyale\src\algo_royale\backtester\strategy\signal\conditions\volatility_spike.py", "Python", 80, 0, 0, 0, 0, 29, 12, 121
"c:\Users\sajit\AlgoRoyale\src\algo_royale\backtester\strategy\signal\conditions\volume_surge.py", "Python", 84, 0, 0, 0, 0, 32, 12, 128
"c:\Users\sajit\AlgoRoyale\src\algo_royale\backtester\strategy\signal\conditions\volume_surge_entry.py", "Python", 48, 0, 0, 0, 0, 1, 9, 58
"c:\Users\sajit\AlgoRoyale\src\algo_royale\backtester\strategy\signal\conditions\volume_surge_exit.py", "Python", 50, 0, 0, 0, 0, 2, 11, 63
"c:\Users\sajit\AlgoRoyale\src\algo_royale\backtester\strategy\signal\conditions\vwap_reversion_entry.py", "Python", 75, 0, 0, 0, 0, 2, 9, 86
"c:\Users\sajit\AlgoRoyale\src\algo_royale\backtester\strategy\signal\conditions\vwap_reversion_exit.py", "Python", 75, 0, 0, 0, 0, 2, 9, 86
"c:\Users\sajit\AlgoRoyale\src\algo_royale\backtester\strategy\signal\conditions\wick_reversal_entry.py", "Python", 50, 0, 0, 0, 0, 0, 8, 58
"c:\Users\sajit\AlgoRoyale\src\algo_royale\backtester\strategy\signal\conditions\wick_reversal_exit.py", "Python", 50, 0, 0, 0, 0, 0, 8, 58
"c:\Users\sajit\AlgoRoyale\src\algo_royale\backtester\strategy\signal\macd_trailing_strategy.py", "Python", 44, 0, 0, 0, 0, 17, 5, 66
"c:\Users\sajit\AlgoRoyale\src\algo_royale\backtester\strategy\signal\manager\symbol_strategy_manager.py", "Python", 74, 0, 0, 0, 0, 11, 5, 90
"c:\Users\sajit\AlgoRoyale\src\algo_royale\backtester\strategy\signal\mean_revision_strategy.py", "Python", 35, 0, 0, 0, 0, 21, 4, 60
"c:\Users\sajit\AlgoRoyale\src\algo_royale\backtester\strategy\signal\mock\mock_signal_strategy.py", "Python", 51, 0, 0, 0, 0, 59, 16, 126
"c:\Users\sajit\AlgoRoyale\src\algo_royale\backtester\strategy\signal\mock\mock_stateful_logic.py", "Python", 55, 0, 0, 0, 0, 67, 17, 139
"c:\Users\sajit\AlgoRoyale\src\algo_royale\backtester\strategy\signal\mock\mock_strategy_condition.py", "Python", 54, 0, 0, 0, 0, 72, 17, 143
"c:\Users\sajit\AlgoRoyale\src\algo_royale\backtester\strategy\signal\momentum_strategy.py", "Python", 39, 0, 0, 0, 0, 21, 4, 64
"c:\Users\sajit\AlgoRoyale\src\algo_royale\backtester\strategy\signal\moving_average_crossover_strategy.py", "Python", 44, 0, 0, 0, 0, 19, 5, 68
"c:\Users\sajit\AlgoRoyale\src\algo_royale\backtester\strategy\signal\moving_average_strategy.py", "Python", 35, 0, 0, 0, 0, 8, 4, 47
"c:\Users\sajit\AlgoRoyale\src\algo_royale\backtester\strategy\signal\pullback_entry_strategy.py", "Python", 34, 0, 0, 0, 0, 4, 4, 42
"c:\Users\sajit\AlgoRoyale\src\algo_royale\backtester\strategy\signal\rsi_strategy.py", "Python", 29, 0, 0, 0, 0, 11, 4, 44
"c:\Users\sajit\AlgoRoyale\src\algo_royale\backtester\strategy\signal\stateful_logic\base_stateful_logic.py", "Python", 53, 0, 0, 0, 0, 40, 14, 107
"c:\Users\sajit\AlgoRoyale\src\algo_royale\backtester\strategy\signal\stateful_logic\macd_trailing_stateful_logic.py", "Python", 108, 0, 0, 0, 0, 26, 18, 152
"c:\Users\sajit\AlgoRoyale\src\algo_royale\backtester\strategy\signal\stateful_logic\mean_reversion_stateful_logic.py", "Python", 118, 0, 0, 0, 0, 4, 14, 136
"c:\Users\sajit\AlgoRoyale\src\algo_royale\backtester\strategy\signal\stateful_logic\trailing_stop_stateful_logic.py", "Python", 60, 0, 0, 0, 0, 8, 13, 81
"c:\Users\sajit\AlgoRoyale\src\algo_royale\backtester\strategy\signal\time_of_day_bias_strategy.py", "Python", 33, 0, 0, 0, 0, 12, 4, 49
"c:\Users\sajit\AlgoRoyale\src\algo_royale\backtester\strategy\signal\trailing_stop_strategy.py", "Python", 30, 0, 0, 0, 0, 8, 4, 42
"c:\Users\sajit\AlgoRoyale\src\algo_royale\backtester\strategy\signal\trend_scraper_strategy.py", "Python", 36, 0, 0, 0, 0, 12, 4, 52
"c:\Users\sajit\AlgoRoyale\src\algo_royale\backtester\strategy\signal\volatility_breakout_strategy.py", "Python", 31, 0, 0, 0, 0, 11, 4, 46
"c:\Users\sajit\AlgoRoyale\src\algo_royale\backtester\strategy\signal\volume_surge_strategy.py", "Python", 34, 0, 0, 0, 0, 10, 6, 50
"c:\Users\sajit\AlgoRoyale\src\algo_royale\backtester\strategy\signal\vwap_reversion_strategy.py", "Python", 35, 0, 0, 0, 0, 11, 5, 51
"c:\Users\sajit\AlgoRoyale\src\algo_royale\backtester\strategy\signal\wick_reversal_strategy.py", "Python", 35, 0, 0, 0, 0, 6, 4, 45
"c:\Users\sajit\AlgoRoyale\src\algo_royale\backtester\strategy_combinator\base_strategy_combinator.py", "Python", 12, 0, 0, 0, 0, 9, 5, 26
"c:\Users\sajit\AlgoRoyale\src\algo_royale\backtester\strategy_combinator\portfolio\base_portfolio_strategy_combinator.py", "Python", 44, 0, 0, 0, 0, 9, 7, 60
"c:\Users\sajit\AlgoRoyale\src\algo_royale\backtester\strategy_combinator\portfolio\equal_risk_contribution_portfolio_strategy_combinator.py", "Python", 14, 0, 0, 0, 0, 0, 3, 17
"c:\Users\sajit\AlgoRoyale\src\algo_royale\backtester\strategy_combinator\portfolio\equal_weight_portfolio_strategy_combinator.py", "Python", 14, 0, 0, 0, 0, 0, 3, 17
"c:\Users\sajit\AlgoRoyale\src\algo_royale\backtester\strategy_combinator\portfolio\inverse_volatility_portfolio_strategy_combinator.py", "Python", 14, 0, 0, 0, 0, 0, 3, 17
"c:\Users\sajit\AlgoRoyale\src\algo_royale\backtester\strategy_combinator\portfolio\max_sharpe_portfolio_strategy_combinator.py", "Python", 14, 0, 0, 0, 0, 0, 3, 17
"c:\Users\sajit\AlgoRoyale\src\algo_royale\backtester\strategy_combinator\portfolio\mean_variance_portfolio_strategy_combinator.py", "Python", 14, 0, 0, 0, 0, 0, 3, 17
"c:\Users\sajit\AlgoRoyale\src\algo_royale\backtester\strategy_combinator\portfolio\minimum_variance_portfolio_strategy_combinator.py", "Python", 14, 0, 0, 0, 0, 0, 3, 17
"c:\Users\sajit\AlgoRoyale\src\algo_royale\backtester\strategy_combinator\portfolio\momentum_portfolio_strategy_combinator.py", "Python", 14, 0, 0, 0, 0, 0, 3, 17
"c:\Users\sajit\AlgoRoyale\src\algo_royale\backtester\strategy_combinator\portfolio\risk_parity_portfolio_strategy_combinator.py", "Python", 18, 0, 0, 0, 0, 4, 4, 26
"c:\Users\sajit\AlgoRoyale\src\algo_royale\backtester\strategy_combinator\portfolio\volatility_weighted_portfolio_strategy_combinator.py", "Python", 14, 0, 0, 0, 0, 0, 3, 17
"c:\Users\sajit\AlgoRoyale\src\algo_royale\backtester\strategy_combinator\portfolio\winner_takes_all_portfolio_strategy_combinator.py", "Python", 14, 0, 0, 0, 0, 0, 3, 17
"c:\Users\sajit\AlgoRoyale\src\algo_royale\backtester\strategy_combinator\signal\base_signal_strategy_combinator.py", "Python", 30, 0, 0, 0, 0, 6, 6, 42
"c:\Users\sajit\AlgoRoyale\src\algo_royale\backtester\strategy_combinator\signal\bollinger_bands_strategy_combinator.py", "Python", 25, 0, 0, 0, 0, 5, 4, 34
"c:\Users\sajit\AlgoRoyale\src\algo_royale\backtester\strategy_combinator\signal\combo_strategy_combinator.py", "Python", 20, 0, 0, 0, 0, 4, 4, 28
"c:\Users\sajit\AlgoRoyale\src\algo_royale\backtester\strategy_combinator\signal\macd_trailing_strategy_combinator.py", "Python", 25, 0, 0, 0, 0, 5, 4, 34
"c:\Users\sajit\AlgoRoyale\src\algo_royale\backtester\strategy_combinator\signal\mean_reversion_strategy_combinator.py", "Python", 22, 0, 0, 0, 0, 4, 4, 30
"c:\Users\sajit\AlgoRoyale\src\algo_royale\backtester\strategy_combinator\signal\momentum_strategy_combinator.py", "Python", 20, 0, 0, 0, 0, 5, 4, 29
"c:\Users\sajit\AlgoRoyale\src\algo_royale\backtester\strategy_combinator\signal\moving_average_crossover_strategy_combinator.py", "Python", 22, 0, 0, 0, 0, 5, 4, 31
"c:\Users\sajit\AlgoRoyale\src\algo_royale\backtester\strategy_combinator\signal\moving_average_strategy_combinator.py", "Python", 22, 0, 0, 0, 0, 4, 4, 30
"c:\Users\sajit\AlgoRoyale\src\algo_royale\backtester\strategy_combinator\signal\pullback_entry_strategy_combinator.py", "Python", 19, 0, 0, 0, 0, 4, 4, 27
"c:\Users\sajit\AlgoRoyale\src\algo_royale\backtester\strategy_combinator\signal\rsi_strategy_combinator.py", "Python", 18, 0, 0, 0, 0, 4, 4, 26
"c:\Users\sajit\AlgoRoyale\src\algo_royale\backtester\strategy_combinator\signal\time_of_day_bias_strategy_combinator.py", "Python", 22, 0, 0, 0, 0, 4, 4, 30
"c:\Users\sajit\AlgoRoyale\src\algo_royale\backtester\strategy_combinator\signal\trailing_stop_strategy_combinator.py", "Python", 57, 0, 0, 0, 0, 4, 4, 65
"c:\Users\sajit\AlgoRoyale\src\algo_royale\backtester\strategy_combinator\signal\trend_scraper_strategy_combinator.py", "Python", 22, 0, 0, 0, 0, 4, 4, 30
"c:\Users\sajit\AlgoRoyale\src\algo_royale\backtester\strategy_combinator\signal\volatility_breakout_strategy_combinator.py", "Python", 22, 0, 0, 0, 0, 4, 4, 30
"c:\Users\sajit\AlgoRoyale\src\algo_royale\backtester\strategy_combinator\signal\volume_surge_strategy_combinator.py", "Python", 19, 0, 0, 0, 0, 5, 4, 28
"c:\Users\sajit\AlgoRoyale\src\algo_royale\backtester\strategy_combinator\signal\vwap_reversion_strategy_combinator.py", "Python", 22, 0, 0, 0, 0, 5, 4, 31
"c:\Users\sajit\AlgoRoyale\src\algo_royale\backtester\strategy_combinator\signal\wick_reversal_strategy_combinator.py", "Python", 22, 0, 0, 0, 0, 6, 4, 32
"c:\Users\sajit\AlgoRoyale\src\algo_royale\backtester\strategy_factory\portfolio\portfolio_strategy_combinator_factory.py", "Python", 68, 0, 0, 0, 0, 9, 9, 86
"c:\Users\sajit\AlgoRoyale\src\algo_royale\backtester\strategy_factory\portfolio\portfolio_strategy_factory.py", "Python", 39, 0, 0, 0, 0, 13, 5, 57
"c:\Users\sajit\AlgoRoyale\src\algo_royale\backtester\strategy_factory\signal\signal_strategy_combinator_factory.py", "Python", 62, 0, 0, 0, 0, 9, 9, 80
"c:\Users\sajit\AlgoRoyale\src\algo_royale\backtester\strategy_factory\signal\signal_strategy_factory.py", "Python", 135, 0, 0, 0, 0, 38, 17, 190
"c:\Users\sajit\AlgoRoyale\src\algo_royale\backtester\walkforward\walk_forward_coordinator.py", "Python", 225, 0, 0, 0, 0, 20, 20, 265
"c:\Users\sajit\AlgoRoyale\src\algo_royale\clients\alpaca\alpaca_base_client.py", "Python", 173, 0, 0, 0, 0, 20, 30, 223
"c:\Users\sajit\AlgoRoyale\src\algo_royale\clients\alpaca\alpaca_market_data\alpaca_corporate_action_client.py", "Python", 71, 0, 0, 0, 0, 17, 13, 101
"c:\Users\sajit\AlgoRoyale\src\algo_royale\clients\alpaca\alpaca_market_data\alpaca_news_client.py", "Python", 73, 0, 0, 0, 0, 5, 15, 93
"c:\Users\sajit\AlgoRoyale\src\algo_royale\clients\alpaca\alpaca_market_data\alpaca_screener_client.py", "Python", 64, 0, 0, 0, 0, 6, 17, 87
"c:\Users\sajit\AlgoRoyale\src\algo_royale\clients\alpaca\alpaca_market_data\alpaca_stock_client.py", "Python", 220, 0, 0, 0, 0, 13, 44, 277
"c:\Users\sajit\AlgoRoyale\src\algo_royale\clients\alpaca\alpaca_market_data\alpaca_stream_client.py", "Python", 149, 0, 0, 0, 0, 62, 25, 236
"c:\Users\sajit\AlgoRoyale\src\algo_royale\clients\alpaca\alpaca_trading\alpaca_accounts_client.py", "Python", 163, 0, 0, 0, 0, 56, 28, 247
"c:\Users\sajit\AlgoRoyale\src\algo_royale\clients\alpaca\alpaca_trading\alpaca_assets_client.py", "Python", 61, 0, 0, 0, 0, 6, 12, 79
"c:\Users\sajit\AlgoRoyale\src\algo_royale\clients\alpaca\alpaca_trading\alpaca_calendar_client.py", "Python", 48, 0, 0, 0, 0, 5, 13, 66
"c:\Users\sajit\AlgoRoyale\src\algo_royale\clients\alpaca\alpaca_trading\alpaca_clock_client.py", "Python", 34, 0, 0, 0, 0, 5, 11, 50
"c:\Users\sajit\AlgoRoyale\src\algo_royale\clients\alpaca\alpaca_trading\alpaca_order_stream_client.py", "Python", 86, 0, 0, 0, 0, 9, 17, 112
"c:\Users\sajit\AlgoRoyale\src\algo_royale\clients\alpaca\alpaca_trading\alpaca_orders_client.py", "Python", 228, 0, 0, 0, 0, 129, 32, 389
"c:\Users\sajit\AlgoRoyale\src\algo_royale\clients\alpaca\alpaca_trading\alpaca_portfolio_client.py", "Python", 65, 0, 0, 0, 0, 45, 12, 122
"c:\Users\sajit\AlgoRoyale\src\algo_royale\clients\alpaca\alpaca_trading\alpaca_positions_client.py", "Python", 89, 0, 0, 0, 0, 41, 17, 147
"c:\Users\sajit\AlgoRoyale\src\algo_royale\clients\alpaca\alpaca_trading\alpaca_watchlist_client.py", "Python", 145, 0, 0, 0, 0, 100, 42, 287
"c:\Users\sajit\AlgoRoyale\src\algo_royale\clients\alpaca\exceptions.py", "Python", 66, 0, 0, 0, 0, 30, 51, 147
"c:\Users\sajit\AlgoRoyale\src\algo_royale\clients\db\dao\base_dao.py", "Python", 73, 0, 0, 0, 0, 35, 11, 119
"c:\Users\sajit\AlgoRoyale\src\algo_royale\clients\db\dao\data_stream_session_dao.py", "Python", 37, 0, 0, 0, 0, 24, 8, 69
"c:\Users\sajit\AlgoRoyale\src\algo_royale\clients\db\dao\enriched_data_dao.py", "Python", 34, 0, 0, 0, 0, 20, 8, 62
"c:\Users\sajit\AlgoRoyale\src\algo_royale\clients\db\dao\order_dao.py", "Python", 112, 0, 0, 0, 0, 72, 15, 199
"c:\Users\sajit\AlgoRoyale\src\algo_royale\clients\db\dao\trade_dao.py", "Python", 86, 0, 0, 0, 0, 31, 13, 130
"c:\Users\sajit\AlgoRoyale\src\algo_royale\clients\db\database.py", "Python", 86, 0, 0, 0, 0, 12, 11, 109
"c:\Users\sajit\AlgoRoyale\src\algo_royale\clients\db\migrations\100_create_initial_schema.sql", "MS SQL", 0, 0, 0, 10, 0, 2, 3, 15
"c:\Users\sajit\AlgoRoyale\src\algo_royale\clients\db\migrations\201_create_orders_table.sql", "MS SQL", 0, 0, 0, 16, 0, 1, 0, 17
"c:\Users\sajit\AlgoRoyale\src\algo_royale\clients\db\migrations\202_create_trades_table.sql", "MS SQL", 0, 0, 0, 16, 0, 2, 1, 19
"c:\Users\sajit\AlgoRoyale\src\algo_royale\clients\db\migrations\203_create_enriched_data_table.sql", "MS SQL", 0, 0, 0, 70, 0, 2, 1, 73
"c:\Users\sajit\AlgoRoyale\src\algo_royale\clients\db\migrations\204_create_data_stream_session_table.sql", "MS SQL", 0, 0, 0, 9, 0, 2, 1, 12
"c:\Users\sajit\AlgoRoyale\src\algo_royale\clients\db\migrations\300_create_indexes.sql", "MS SQL", 0, 0, 0, 2, 0, 2, 2, 6
"c:\Users\sajit\AlgoRoyale\src\algo_royale\clients\db\migrations\migration_manager.py", "Python", 28, 0, 0, 0, 0, 11, 10, 49
"c:\Users\sajit\AlgoRoyale\src\algo_royale\clients\db\schema.sql", "MS SQL", 0, 0, 0, 122, 0, 10, 9, 141
"c:\Users\sajit\AlgoRoyale\src\algo_royale\clients\db\sql\data_stream_session\delete_all_data_stream_session.sql", "MS SQL", 0, 0, 0, 1, 0, 0, 0, 1
"c:\Users\sajit\AlgoRoyale\src\algo_royale\clients\db\sql\data_stream_session\fetch_data_stream_session_by_timestamp.sql", "MS SQL", 0, 0, 0, 1, 0, 0, 0, 1
"c:\Users\sajit\AlgoRoyale\src\algo_royale\clients\db\sql\data_stream_session\insert_data_stream_session.sql", "MS SQL", 0, 0, 0, 8, 0, 0, 1, 9
"c:\Users\sajit\AlgoRoyale\src\algo_royale\clients\db\sql\data_stream_session\update_data_stream_session_end_time.sql", "MS SQL", 0, 0, 0, 5, 0, 0, 1, 6
"c:\Users\sajit\AlgoRoyale\src\algo_royale\clients\db\sql\enriched_data\delete_all_enriched_data.sql", "MS SQL", 0, 0, 0, 1, 0, 0, 0, 1
"c:\Users\sajit\AlgoRoyale\src\algo_royale\clients\db\sql\enriched_data\fetch_enriched_data_by_order_id.sql", "MS SQL", 0, 0, 0, 1, 0, 0, 0, 1
"c:\Users\sajit\AlgoRoyale\src\algo_royale\clients\db\sql\enriched_data\insert_enriched_data.sql", "MS SQL", 0, 0, 0, 79, 0, 0, 0, 79
"c:\Users\sajit\AlgoRoyale\src\algo_royale\clients\db\sql\orders\delete_all_orders.sql", "MS SQL", 0, 0, 0, 1, 0, 1, 1, 3
"c:\Users\sajit\AlgoRoyale\src\algo_royale\clients\db\sql\orders\delete_order.sql", "MS SQL", 0, 0, 0, 2, 0, 1, 0, 3
"c:\Users\sajit\AlgoRoyale\src\algo_royale\clients\db\sql\orders\fetch_all_orders_by_status.sql", "MS SQL", 0, 0, 0, 1, 0, 1, 0, 2
"c:\Users\sajit\AlgoRoyale\src\algo_royale\clients\db\sql\orders\fetch_all_orders_by_symbol_and_status.sql", "MS SQL", 0, 0, 0, 3, 0, 1, 0, 4
"c:\Users\sajit\AlgoRoyale\src\algo_royale\clients\db\sql\orders\fetch_order_by_id.sql", "MS SQL", 0, 0, 0, 1, 0, 1, 0, 2
"c:\Users\sajit\AlgoRoyale\src\algo_royale\clients\db\sql\orders\fetch_orders_by_status.sql", "MS SQL", 0, 0, 0, 5, 0, 0, 0, 5
"c:\Users\sajit\AlgoRoyale\src\algo_royale\clients\db\sql\orders\fetch_orders_by_symbol_and_status.sql", "MS SQL", 0, 0, 0, 4, 0, 1, 0, 5
"c:\Users\sajit\AlgoRoyale\src\algo_royale\clients\db\sql\orders\fetch_unsettled_orders.sql", "MS SQL", 0, 0, 0, 1, 0, 1, 1, 3
"c:\Users\sajit\AlgoRoyale\src\algo_royale\clients\db\sql\orders\insert_order.sql", "MS SQL", 0, 0, 0, 3, 0, 1, 0, 4
"c:\Users\sajit\AlgoRoyale\src\algo_royale\clients\db\sql\orders\update_order.sql", "MS SQL", 0, 0, 0, 7, 0, 1, 0, 8
"c:\Users\sajit\AlgoRoyale\src\algo_royale\clients\db\sql\orders\update_order_as_settled.sql", "MS SQL", 0, 0, 0, 1, 0, 1, 0, 2
"c:\Users\sajit\AlgoRoyale\src\algo_royale\clients\db\sql\trades\delete_all_trades.sql", "MS SQL", 0, 0, 0, 1, 0, 1, 0, 2
"c:\Users\sajit\AlgoRoyale\src\algo_royale\clients\db\sql\trades\delete_trade.sql", "MS SQL", 0, 0, 0, 1, 0, 1, 2, 4
"c:\Users\sajit\AlgoRoyale\src\algo_royale\clients\db\sql\trades\fetch_open_positions.sql", "MS SQL", 0, 0, 0, 20, 0, 1, 0, 21
"c:\Users\sajit\AlgoRoyale\src\algo_royale\clients\db\sql\trades\fetch_trades_by_data_range.sql", "MS SQL", 0, 0, 0, 4, 0, 0, 1, 5
"c:\Users\sajit\AlgoRoyale\src\algo_royale\clients\db\sql\trades\fetch_trades_by_order_id.sql", "MS SQL", 0, 0, 0, 3, 0, 1, 0, 4
"c:\Users\sajit\AlgoRoyale\src\algo_royale\clients\db\sql\trades\fetch_unsettled_trades.sql", "MS SQL", 0, 0, 0, 1, 0, 3, 1, 5
"c:\Users\sajit\AlgoRoyale\src\algo_royale\clients\db\sql\trades\insert_trade.sql", "MS SQL", 0, 0, 0, 3, 0, 2, 1, 6
"c:\Users\sajit\AlgoRoyale\src\algo_royale\clients\db\sql\trades\update_settled_trades.sql", "MS SQL", 0, 0, 0, 4, 0, 0, 0, 4
"c:\Users\sajit\AlgoRoyale\src\algo_royale\clients\db\sql\trades\update_trade.sql", "MS SQL", 0, 0, 0, 1, 0, 1, 0, 2
"c:\Users\sajit\AlgoRoyale\src\algo_royale\config\config.ini", "Ini", 0, 0, 0, 0, 76, 0, 17, 93
"c:\Users\sajit\AlgoRoyale\src\algo_royale\config\config.py", "Python", 41, 0, 0, 0, 0, 42, 13, 96
"c:\Users\sajit\AlgoRoyale\src\algo_royale\di\adapter\adapter_container.py", "Python", 114, 0, 0, 0, 0, 3, 20, 137
"c:\Users\sajit\AlgoRoyale\src\algo_royale\di\adapter\client_container.py", "Python", 257, 0, 0, 0, 0, 1, 21, 279
"c:\Users\sajit\AlgoRoyale\src\algo_royale\di\application_container.py", "Python", 81, 0, 0, 0, 0, 0, 15, 96
"c:\Users\sajit\AlgoRoyale\src\algo_royale\di\backtest\backtest_pipeline_container.py", "Python", 63, 0, 0, 0, 0, 0, 7, 70
"c:\Users\sajit\AlgoRoyale\src\algo_royale\di\backtest\data_prep_coordinator_container.py", "Python", 43, 0, 0, 0, 0, 1, 7, 51
"c:\Users\sajit\AlgoRoyale\src\algo_royale\di\backtest\portfolio_backtest_container.py", "Python", 149, 0, 0, 0, 0, 2, 14, 165
"c:\Users\sajit\AlgoRoyale\src\algo_royale\di\backtest\signal_backtest_container.py", "Python", 106, 0, 0, 0, 0, 1, 11, 118
"c:\Users\sajit\AlgoRoyale\src\algo_royale\di\factory_container.py", "Python", 63, 0, 0, 0, 0, 1, 10, 74
"c:\Users\sajit\AlgoRoyale\src\algo_royale\di\feature_engineering_container.py", "Python", 32, 0, 0, 0, 0, 0, 8, 40
"c:\Users\sajit\AlgoRoyale\src\algo_royale\di\ledger_service_container.py", "Python", 69, 0, 0, 0, 0, 0, 10, 79
"c:\Users\sajit\AlgoRoyale\src\algo_royale\di\logger_container.py", "Python", 16, 0, 0, 0, 0, 0, 5, 21
"c:\Users\sajit\AlgoRoyale\src\algo_royale\di\repo\dao_container.py", "Python", 41, 0, 0, 0, 0, 1, 9, 51
"c:\Users\sajit\AlgoRoyale\src\algo_royale\di\repo\db_container.py", "Python", 15, 0, 0, 0, 0, 0, 6, 21
"c:\Users\sajit\AlgoRoyale\src\algo_royale\di\repo\repo_container.py", "Python", 58, 0, 0, 0, 0, 1, 12, 71
"c:\Users\sajit\AlgoRoyale\src\algo_royale\di\stage_data_container.py", "Python", 74, 0, 0, 0, 0, 0, 11, 85
"c:\Users\sajit\AlgoRoyale\src\algo_royale\di\trading\market_session_container.py", "Python", 48, 0, 0, 0, 0, 0, 7, 55
"c:\Users\sajit\AlgoRoyale\src\algo_royale\di\trading\order_generator_service_container.py", "Python", 101, 0, 0, 0, 0, 0, 14, 115
"c:\Users\sajit\AlgoRoyale\src\algo_royale\di\trading\registry_container.py", "Python", 42, 0, 0, 0, 0, 0, 6, 48
"c:\Users\sajit\AlgoRoyale\src\algo_royale\di\trading\trading_container.py", "Python", 86, 0, 0, 0, 0, 1, 12, 99
"c:\Users\sajit\AlgoRoyale\src\algo_royale\logging\custom_rotating_file_handler.py", "Python", 18, 0, 0, 0, 0, 6, 8, 32
"c:\Users\sajit\AlgoRoyale\src\algo_royale\logging\loggable.py", "Python", 37, 0, 0, 0, 0, 1, 15, 53
"c:\Users\sajit\AlgoRoyale\src\algo_royale\logging\logger_env.py", "Python", 5, 0, 0, 0, 0, 0, 3, 8
"c:\Users\sajit\AlgoRoyale\src\algo_royale\logging\logger_factory.py", "Python", 41, 0, 0, 0, 0, 3, 15, 59
"c:\Users\sajit\AlgoRoyale\src\algo_royale\logging\logger_type.py", "Python", 128, 0, 0, 0, 0, 19, 24, 171
"c:\Users\sajit\AlgoRoyale\src\algo_royale\models\alpaca_market_data\alpaca_active_stock.py", "Python", 26, 0, 0, 0, 0, 42, 11, 79
"c:\Users\sajit\AlgoRoyale\src\algo_royale\models\alpaca_market_data\alpaca_auction.py", "Python", 48, 0, 0, 0, 0, 20, 16, 84
"c:\Users\sajit\AlgoRoyale\src\algo_royale\models\alpaca_market_data\alpaca_bar.py", "Python", 91, 0, 0, 0, 0, 68, 22, 181
"c:\Users\sajit\AlgoRoyale\src\algo_royale\models\alpaca_market_data\alpaca_condition_code.py", "Python", 16, 0, 0, 0, 0, 29, 12, 57
"c:\Users\sajit\AlgoRoyale\src\algo_royale\models\alpaca_market_data\alpaca_corporate_action.py", "Python", 59, 0, 0, 0, 0, 63, 19, 141
"c:\Users\sajit\AlgoRoyale\src\algo_royale\models\alpaca_market_data\alpaca_market_mover.py", "Python", 29, 0, 0, 0, 0, 65, 11, 105
"c:\Users\sajit\AlgoRoyale\src\algo_royale\models\alpaca_market_data\alpaca_news.py", "Python", 48, 0, 0, 0, 0, 107, 16, 171
"c:\Users\sajit\AlgoRoyale\src\algo_royale\models\alpaca_market_data\alpaca_quote.py", "Python", 44, 0, 0, 0, 0, 81, 12, 137
"c:\Users\sajit\AlgoRoyale\src\algo_royale\models\alpaca_market_data\alpaca_snapshot.py", "Python", 71, 0, 0, 0, 0, 64, 22, 157
"c:\Users\sajit\AlgoRoyale\src\algo_royale\models\alpaca_market_data\alpaca_stream_bar.py", "Python", 30, 0, 0, 0, 0, 25, 5, 60
"c:\Users\sajit\AlgoRoyale\src\algo_royale\models\alpaca_market_data\alpaca_stream_quote.py", "Python", 29, 0, 0, 0, 0, 24, 6, 59
"c:\Users\sajit\AlgoRoyale\src\algo_royale\models\alpaca_market_data\alpaca_trade.py", "Python", 48, 0, 0, 0, 0, 56, 20, 124
"c:\Users\sajit\AlgoRoyale\src\algo_royale\models\alpaca_market_data\enums.py", "Python", 44, 0, 0, 0, 0, 26, 12, 82
"c:\Users\sajit\AlgoRoyale\src\algo_royale\models\alpaca_trading\alpaca_account.py", "Python", 169, 0, 0, 0, 0, 21, 18, 208
"c:\Users\sajit\AlgoRoyale\src\algo_royale\models\alpaca_trading\alpaca_asset.py", "Python", 35, 0, 0, 0, 0, 37, 7, 79
"c:\Users\sajit\AlgoRoyale\src\algo_royale\models\alpaca_trading\alpaca_calendar.py", "Python", 33, 0, 0, 0, 0, 26, 13, 72
"c:\Users\sajit\AlgoRoyale\src\algo_royale\models\alpaca_trading\alpaca_clock.py", "Python", 17, 0, 0, 0, 0, 19, 6, 42
"c:\Users\sajit\AlgoRoyale\src\algo_royale\models\alpaca_trading\alpaca_order.py", "Python", 124, 0, 0, 0, 0, 78, 40, 242
"c:\Users\sajit\AlgoRoyale\src\algo_royale\models\alpaca_trading\alpaca_portfolio.py", "Python", 15, 0, 0, 0, 0, 21, 7, 43
"c:\Users\sajit\AlgoRoyale\src\algo_royale\models\alpaca_trading\alpaca_position.py", "Python", 80, 0, 0, 0, 0, 43, 30, 153
"c:\Users\sajit\AlgoRoyale\src\algo_royale\models\alpaca_trading\alpaca_watchlist.py", "Python", 32, 0, 0, 0, 0, 27, 12, 71
"c:\Users\sajit\AlgoRoyale\src\algo_royale\models\alpaca_trading\enums\enums.py", "Python", 139, 0, 0, 0, 0, 294, 66, 499
"c:\Users\sajit\AlgoRoyale\src\algo_royale\models\alpaca_trading\enums\order_stream_event.py", "Python", 102, 0, 0, 0, 0, 35, 13, 150
"c:\Users\sajit\AlgoRoyale\src\algo_royale\models\alpaca_trading\order_stream_data.py", "Python", 19, 0, 0, 0, 0, 9, 7, 35
"c:\Users\sajit\AlgoRoyale\src\algo_royale\models\db\db_data_stream_session.py", "Python", 34, 0, 0, 0, 0, 33, 8, 75
"c:\Users\sajit\AlgoRoyale\src\algo_royale\models\db\db_enriched_data.py", "Python", 216, 0, 0, 0, 0, 62, 8, 286
"c:\Users\sajit\AlgoRoyale\src\algo_royale\models\db\db_order.py", "Python", 57, 0, 0, 0, 0, 38, 8, 103
"c:\Users\sajit\AlgoRoyale\src\algo_royale\models\db\db_position.py", "Python", 28, 0, 0, 0, 0, 16, 7, 51
"c:\Users\sajit\AlgoRoyale\src\algo_royale\models\db\db_trade.py", "Python", 55, 0, 0, 0, 0, 41, 8, 104
"c:\Users\sajit\AlgoRoyale\src\algo_royale\repo\data_stream_session_repo.py", "Python", 30, 0, 0, 0, 0, 24, 8, 62
"c:\Users\sajit\AlgoRoyale\src\algo_royale\repo\enriched_data_repo.py", "Python", 24, 0, 0, 0, 0, 15, 7, 46
"c:\Users\sajit\AlgoRoyale\src\algo_royale\repo\order_repo.py", "Python", 98, 0, 0, 0, 0, 52, 20, 170
"c:\Users\sajit\AlgoRoyale\src\algo_royale\repo\trade_repo.py", "Python", 72, 0, 0, 0, 0, 37, 15, 124
"c:\Users\sajit\AlgoRoyale\src\algo_royale\repo\watchlist_repo.py", "Python", 27, 0, 0, 0, 0, 4, 9, 40
"c:\Users\sajit\AlgoRoyale\src\algo_royale\routes\indicator_routes.py", "Python", 57, 0, 0, 0, 0, 6, 12, 75
"c:\Users\sajit\AlgoRoyale\src\algo_royale\routes\news_sentiment_routes.py", "Python", 45, 0, 0, 0, 0, 5, 12, 62
"c:\Users\sajit\AlgoRoyale\src\algo_royale\routes\order_routes.py", "Python", 33, 0, 0, 0, 0, 4, 8, 45
"c:\Users\sajit\AlgoRoyale\src\algo_royale\routes\position_routes.py", "Python", 13, 0, 0, 0, 0, 5, 6, 24
"c:\Users\sajit\AlgoRoyale\src\algo_royale\routes\trade_routes.py", "Python", 25, 0, 0, 0, 0, 1, 9, 35
"c:\Users\sajit\AlgoRoyale\src\algo_royale\routes\trade_signal_routes.py", "Python", 14, 0, 0, 0, 0, 5, 8, 27
"c:\Users\sajit\AlgoRoyale\src\algo_royale\services\account_cash_service.py", "Python", 25, 0, 0, 0, 0, 4, 8, 37
"c:\Users\sajit\AlgoRoyale\src\algo_royale\services\clock_service.py", "Python", 76, 0, 0, 0, 0, 17, 14, 107
"c:\Users\sajit\AlgoRoyale\src\algo_royale\services\enriched_data_service.py", "Python", 34, 0, 0, 0, 0, 0, 6, 40
"c:\Users\sajit\AlgoRoyale\src\algo_royale\services\ledger_service.py", "Python", 80, 0, 0, 0, 0, 7, 11, 98
"c:\Users\sajit\AlgoRoyale\src\algo_royale\services\market_session_service.py", "Python", 150, 0, 0, 0, 0, 18, 16, 184
"c:\Users\sajit\AlgoRoyale\src\algo_royale\services\order_event_service.py", "Python", 54, 0, 0, 0, 0, 4, 10, 68
"c:\Users\sajit\AlgoRoyale\src\algo_royale\services\order_generator_service.py", "Python", 103, 0, 0, 0, 0, 0, 11, 114
"c:\Users\sajit\AlgoRoyale\src\algo_royale\services\order_monitor_service.py", "Python", 126, 0, 0, 0, 0, 9, 16, 151
"c:\Users\sajit\AlgoRoyale\src\algo_royale\services\orders_execution_service.py", "Python", 145, 0, 0, 0, 0, 11, 12, 168
"c:\Users\sajit\AlgoRoyale\src\algo_royale\services\orders_service.py", "Python", 143, 0, 0, 0, 0, 0, 9, 152
"c:\Users\sajit\AlgoRoyale\src\algo_royale\services\positions_service.py", "Python", 97, 0, 0, 0, 0, 21, 19, 137
"c:\Users\sajit\AlgoRoyale\src\algo_royale\services\symbol_hold_service.py", "Python", 198, 0, 0, 0, 0, 13, 22, 233
"c:\Users\sajit\AlgoRoyale\src\algo_royale\services\symbol_service.py", "Python", 32, 0, 0, 0, 0, 9, 6, 47
"c:\Users\sajit\AlgoRoyale\src\algo_royale\services\trade_orchestrator.py", "Python", 61, 0, 0, 0, 0, 4, 9, 74
"c:\Users\sajit\AlgoRoyale\src\algo_royale\services\trades_service.py", "Python", 258, 0, 0, 0, 0, 42, 28, 328
"c:\Users\sajit\AlgoRoyale\src\algo_royale\utils\path_utils.py", "Python", 11, 0, 0, 0, 0, 2, 3, 16
"c:\Users\sajit\AlgoRoyale\src\algo_royale\visualization\backtest_visualizer.py", "Python", 252, 0, 0, 0, 0, 93, 50, 395
"c:\Users\sajit\AlgoRoyale\src\algo_royale\visualization\cli.py", "Python", 27, 0, 0, 0, 0, 3, 4, 34
"c:\Users\sajit\AlgoRoyale\src\algo_royale\visualization\dashboard.py", "Python", 168, 0, 0, 0, 0, 16, 46, 230
"c:\Users\sajit\AlgoRoyale\src\app.py", "Python", 16, 0, 0, 0, 0, 6, 7, 29
"c:\Users\sajit\AlgoRoyale\tests\integration\client\alpaca_market_data\test_alpaca_corporate_action_client.py", "Python", 0, 0, 0, 0, 0, 0, 1, 1
"c:\Users\sajit\AlgoRoyale\tests\integration\client\alpaca_market_data\test_alpaca_news_client.py", "Python", 0, 0, 0, 0, 0, 0, 1, 1
"c:\Users\sajit\AlgoRoyale\tests\integration\client\alpaca_market_data\test_alpaca_screener_client.py", "Python", 0, 0, 0, 0, 0, 0, 1, 1
"c:\Users\sajit\AlgoRoyale\tests\integration\client\alpaca_market_data\test_alpaca_stock_client.py", "Python", 0, 0, 0, 0, 0, 0, 1, 1
"c:\Users\sajit\AlgoRoyale\tests\integration\client\alpaca_market_data\test_alpaca_stream_client.py", "Python", 0, 0, 0, 0, 0, 0, 1, 1
"c:\Users\sajit\AlgoRoyale\tests\integration\client\alpaca_trading\test_alpaca_account_client.py", "Python", 0, 0, 0, 0, 0, 0, 1, 1
"c:\Users\sajit\AlgoRoyale\tests\integration\client\alpaca_trading\test_alpaca_asset_client.py", "Python", 0, 0, 0, 0, 0, 0, 1, 1
"c:\Users\sajit\AlgoRoyale\tests\integration\client\alpaca_trading\test_alpaca_calendar_client.py", "Python", 0, 0, 0, 0, 0, 0, 1, 1
"c:\Users\sajit\AlgoRoyale\tests\integration\client\alpaca_trading\test_alpaca_clock_client.py", "Python", 0, 0, 0, 0, 0, 0, 1, 1
"c:\Users\sajit\AlgoRoyale\tests\integration\client\alpaca_trading\test_alpaca_orders_client.py", "Python", 0, 0, 0, 0, 0, 0, 1, 1
"c:\Users\sajit\AlgoRoyale\tests\integration\client\alpaca_trading\test_alpaca_portfolio_client.py", "Python", 0, 0, 0, 0, 0, 0, 1, 1
"c:\Users\sajit\AlgoRoyale\tests\integration\client\alpaca_trading\test_alpaca_positions_client.py", "Python", 0, 0, 0, 0, 0, 0, 1, 1
"c:\Users\sajit\AlgoRoyale\tests\integration\client\alpaca_trading\test_alpaca_watchlist_client.py", "Python", 0, 0, 0, 0, 0, 0, 1, 1
"c:\Users\sajit\AlgoRoyale\tests\mocks\adapters\mock_account_adapter.py", "Python", 22, 0, 0, 0, 0, 0, 8, 30
"c:\Users\sajit\AlgoRoyale\tests\mocks\adapters\mock_account_cash_adapter.py", "Python", 47, 0, 0, 0, 0, 0, 8, 55
"c:\Users\sajit\AlgoRoyale\tests\mocks\adapters\mock_assets_adapter.py", "Python", 15, 0, 0, 0, 0, 0, 5, 20
"c:\Users\sajit\AlgoRoyale\tests\mocks\adapters\mock_calendar_adapter.py", "Python", 20, 0, 0, 0, 0, 0, 7, 27
"c:\Users\sajit\AlgoRoyale\tests\mocks\adapters\mock_clock_adapter.py", "Python", 16, 0, 0, 0, 0, 0, 7, 23
"c:\Users\sajit\AlgoRoyale\tests\mocks\adapters\mock_corporate_action_adapter.py", "Python", 16, 0, 0, 0, 0, 0, 5, 21
"c:\Users\sajit\AlgoRoyale\tests\mocks\adapters\mock_news_adapter.py", "Python", 12, 0, 0, 0, 0, 0, 5, 17
"c:\Users\sajit\AlgoRoyale\tests\mocks\adapters\mock_order_stream_adapter.py", "Python", 20, 0, 0, 0, 0, 1, 8, 29
"c:\Users\sajit\AlgoRoyale\tests\mocks\adapters\mock_orders_adapter.py", "Python", 16, 0, 0, 0, 0, 0, 7, 23
"c:\Users\sajit\AlgoRoyale\tests\mocks\adapters\mock_portfolio_adapter.py", "Python", 18, 0, 0, 0, 0, 0, 7, 25
"c:\Users\sajit\AlgoRoyale\tests\mocks\adapters\mock_positions_adapter.py", "Python", 18, 0, 0, 0, 0, 0, 7, 25
"c:\Users\sajit\AlgoRoyale\tests\mocks\adapters\mock_quote_adapter.py", "Python", 13, 0, 0, 0, 0, 0, 5, 18
"c:\Users\sajit\AlgoRoyale\tests\mocks\adapters\mock_screener_adapter.py", "Python", 19, 0, 0, 0, 0, 0, 6, 25
"c:\Users\sajit\AlgoRoyale\tests\mocks\adapters\mock_stream_adapter.py", "Python", 13, 0, 0, 0, 0, 0, 5, 18
"c:\Users\sajit\AlgoRoyale\tests\mocks\adapters\mock_watchlist_adapter.py", "Python", 15, 0, 0, 0, 0, 0, 5, 20
"c:\Users\sajit\AlgoRoyale\tests\mocks\backtester\mock_stage_data_manager.py", "Python", 142, 0, 0, 0, 0, 0, 26, 168
"c:\Users\sajit\AlgoRoyale\tests\mocks\backtester\stage_data\loader\mock_stage_data_loader.py", "Python", 65, 0, 0, 0, 0, 0, 11, 76
"c:\Users\sajit\AlgoRoyale\tests\mocks\backtester\stage_data\writer\mock_stage_data_writer.py", "Python", 37, 0, 0, 0, 0, 0, 9, 46
"c:\Users\sajit\AlgoRoyale\tests\mocks\clients\alpaca\mock_alpaca_account_client.py", "Python", 129, 0, 0, 0, 0, 0, 9, 138
"c:\Users\sajit\AlgoRoyale\tests\mocks\clients\alpaca\mock_alpaca_asset_client.py", "Python", 58, 0, 0, 0, 0, 0, 6, 64
"c:\Users\sajit\AlgoRoyale\tests\mocks\clients\alpaca\mock_alpaca_calendar_client.py", "Python", 40, 0, 0, 0, 0, 0, 6, 46
"c:\Users\sajit\AlgoRoyale\tests\mocks\clients\alpaca\mock_alpaca_clock_client.py", "Python", 36, 0, 0, 0, 0, 0, 5, 41
"c:\Users\sajit\AlgoRoyale\tests\mocks\clients\alpaca\mock_alpaca_corporate_action_client.py", "Python", 65, 0, 0, 0, 0, 1, 6, 72
"c:\Users\sajit\AlgoRoyale\tests\mocks\clients\alpaca\mock_alpaca_news_client.py", "Python", 48, 0, 0, 0, 0, 1, 5, 54
"c:\Users\sajit\AlgoRoyale\tests\mocks\clients\alpaca\mock_alpaca_order_stream_client.py", "Python", 77, 0, 0, 0, 0, 7, 16, 100
"c:\Users\sajit\AlgoRoyale\tests\mocks\clients\alpaca\mock_alpaca_orders_client.py", "Python", 161, 0, 0, 0, 0, 2, 11, 174
"c:\Users\sajit\AlgoRoyale\tests\mocks\clients\alpaca\mock_alpaca_portfolio_client.py", "Python", 49, 0, 0, 0, 0, 0, 6, 55
"c:\Users\sajit\AlgoRoyale\tests\mocks\clients\alpaca\mock_alpaca_positions_client.py", "Python", 132, 0, 0, 0, 0, 2, 8, 142
"c:\Users\sajit\AlgoRoyale\tests\mocks\clients\alpaca\mock_alpaca_screener_client.py", "Python", 55, 0, 0, 0, 0, 0, 5, 60
"c:\Users\sajit\AlgoRoyale\tests\mocks\clients\alpaca\mock_alpaca_stock_client.py", "Python", 179, 0, 0, 0, 0, 1, 5, 185
"c:\Users\sajit\AlgoRoyale\tests\mocks\clients\alpaca\mock_alpaca_stream_client.py", "Python", 29, 0, 0, 0, 0, 0, 6, 35
"c:\Users\sajit\AlgoRoyale\tests\mocks\clients\alpaca\mock_alpaca_watchlist_client.py", "Python", 141, 0, 0, 0, 0, 0, 17, 158
"c:\Users\sajit\AlgoRoyale\tests\mocks\clients\db\mock_data_stream_session_dao.py", "Python", 34, 0, 0, 0, 0, 0, 11, 45
"c:\Users\sajit\AlgoRoyale\tests\mocks\clients\db\mock_enriched_data_dao.py", "Python", 87, 0, 0, 0, 0, 0, 9, 96
"c:\Users\sajit\AlgoRoyale\tests\mocks\clients\db\mock_order_dao.py", "Python", 70, 0, 0, 0, 0, 1, 17, 88
"c:\Users\sajit\AlgoRoyale\tests\mocks\clients\db\mock_trade_dao.py", "Python", 89, 0, 0, 0, 0, 0, 15, 104
"c:\Users\sajit\AlgoRoyale\tests\mocks\mock_loggable.py", "Python", 13, 0, 0, 0, 0, 1, 6, 20
"c:\Users\sajit\AlgoRoyale\tests\mocks\repo\mock_data_stream_session_repo.py", "Python", 50, 0, 0, 0, 0, 0, 11, 61
"c:\Users\sajit\AlgoRoyale\tests\mocks\repo\mock_enriched_data_repo.py", "Python", 49, 0, 0, 0, 0, 0, 13, 62
"c:\Users\sajit\AlgoRoyale\tests\mocks\repo\mock_order_repo.py", "Python", 121, 0, 0, 0, 0, 0, 19, 140
"c:\Users\sajit\AlgoRoyale\tests\mocks\repo\mock_trade_repo.py", "Python", 103, 0, 0, 0, 0, 0, 18, 121
"c:\Users\sajit\AlgoRoyale\tests\mocks\repo\mock_watchlist_repo.py", "Python", 32, 0, 0, 0, 0, 0, 11, 43
"c:\Users\sajit\AlgoRoyale\tests\mocks\services\mock_account_cash_service.py", "Python", 17, 0, 0, 0, 0, 0, 6, 23
"c:\Users\sajit\AlgoRoyale\tests\mocks\services\mock_clock_service.py", "Python", 20, 0, 0, 0, 0, 0, 8, 28
"c:\Users\sajit\AlgoRoyale\tests\mocks\services\mock_enriched_data_service.py", "Python", 41, 0, 0, 0, 0, 0, 11, 52
"c:\Users\sajit\AlgoRoyale\tests\mocks\services\mock_ledger_service.py", "Python", 115, 0, 0, 0, 0, 0, 17, 132
"c:\Users\sajit\AlgoRoyale\tests\mocks\services\mock_order_event_service.py", "Python", 38, 0, 0, 0, 0, 0, 10, 48
"c:\Users\sajit\AlgoRoyale\tests\mocks\services\mock_order_service.py", "Python", 34, 0, 0, 0, 0, 0, 8, 42
"c:\Users\sajit\AlgoRoyale\tests\mocks\services\mock_positions_service.py", "Python", 101, 0, 0, 0, 0, 1, 13, 115
"c:\Users\sajit\AlgoRoyale\tests\mocks\services\mock_trades_service.py", "Python", 125, 0, 0, 0, 0, 0, 17, 142
"c:\Users\sajit\AlgoRoyale\tests\tests\algo_royale\adapters\market_data\test_corporate_action_adapter.py", "Python", 51, 0, 0, 0, 0, 5, 11, 67
"c:\Users\sajit\AlgoRoyale\tests\tests\algo_royale\adapters\market_data\test_news_adapter.py", "Python", 42, 0, 0, 0, 0, 0, 11, 53
"c:\Users\sajit\AlgoRoyale\tests\tests\algo_royale\adapters\market_data\test_quote_adapter.py", "Python", 57, 0, 0, 0, 0, 1, 19, 77
"c:\Users\sajit\AlgoRoyale\tests\tests\algo_royale\adapters\market_data\test_screener_adapter.py", "Python", 33, 0, 0, 0, 0, 0, 10, 43
"c:\Users\sajit\AlgoRoyale\tests\tests\algo_royale\adapters\market_data\test_stream_adapter.py", "Python", 30, 0, 0, 0, 0, 4, 10, 44
"c:\Users\sajit\AlgoRoyale\tests\tests\algo_royale\adapters\trading\test_account_adapter.py", "Python", 75, 0, 0, 0, 0, 0, 21, 96
"c:\Users\sajit\AlgoRoyale\tests\tests\algo_royale\adapters\trading\test_assets_adapter.py", "Python", 27, 0, 0, 0, 0, 0, 9, 36
"c:\Users\sajit\AlgoRoyale\tests\tests\algo_royale\adapters\trading\test_calendar_adapter.py", "Python", 40, 0, 0, 0, 0, 0, 11, 51
"c:\Users\sajit\AlgoRoyale\tests\tests\algo_royale\adapters\trading\test_clock_adapter.py", "Python", 22, 0, 0, 0, 0, 0, 8, 30
"c:\Users\sajit\AlgoRoyale\tests\tests\algo_royale\adapters\trading\test_order_stream_adapter.py", "Python", 20, 0, 0, 0, 0, 2, 9, 31
"c:\Users\sajit\AlgoRoyale\tests\tests\algo_royale\adapters\trading\test_orders_adapter.py", "Python", 58, 0, 0, 0, 0, 1, 15, 74
"c:\Users\sajit\AlgoRoyale\tests\tests\algo_royale\adapters\trading\test_portfolio_adapter.py", "Python", 28, 0, 0, 0, 0, 1, 7, 36
"c:\Users\sajit\AlgoRoyale\tests\tests\algo_royale\adapters\trading\test_positions_adapter.py", "Python", 51, 0, 0, 0, 0, 0, 13, 64
"c:\Users\sajit\AlgoRoyale\tests\tests\algo_royale\adapters\trading\test_watchlist_adapter.py", "Python", 60, 0, 0, 0, 0, 2, 15, 77
"c:\Users\sajit\AlgoRoyale\tests\tests\algo_royale\backtester\data_preparer\test_asset_matrix_preparer.py", "Python", 93, 0, 0, 0, 0, 0, 10, 103
"c:\Users\sajit\AlgoRoyale\tests\tests\algo_royale\backtester\data_preparer\test_stage_data_preparer.py", "Python", 127, 0, 0, 0, 0, 10, 38, 175
"c:\Users\sajit\AlgoRoyale\tests\tests\algo_royale\backtester\evaluator\backtest\test_portfolio_backtest_evaluator.py", "Python", 81, 0, 0, 0, 0, 0, 26, 107
"c:\Users\sajit\AlgoRoyale\tests\tests\algo_royale\backtester\evaluator\backtest\test_signal_backtest_evaluator.py", "Python", 75, 0, 0, 0, 0, 0, 22, 97
"c:\Users\sajit\AlgoRoyale\tests\tests\algo_royale\backtester\evaluator\portfolio\test_portfolio_cross_strategy_summary.py", "Python", 77, 0, 0, 0, 0, 5, 20, 102
"c:\Users\sajit\AlgoRoyale\tests\tests\algo_royale\backtester\evaluator\portfolio\test_portfolio_cross_window_evaluator.py", "Python", 63, 0, 0, 0, 0, 5, 18, 86
"c:\Users\sajit\AlgoRoyale\tests\tests\algo_royale\backtester\evaluator\portfolio\test_portfolio_evaluation_coordinator.py", "Python", 84, 0, 0, 0, 0, 5, 13, 102
"c:\Users\sajit\AlgoRoyale\tests\tests\algo_royale\backtester\executor\test_portfolio_backtest_executor.py", "Python", 67, 0, 0, 0, 0, 6, 11, 84
"c:\Users\sajit\AlgoRoyale\tests\tests\algo_royale\backtester\executor\test_strategy_backtest_executor.py", "Python", 159, 0, 0, 0, 0, 4, 29, 192
"c:\Users\sajit\AlgoRoyale\tests\tests\algo_royale\backtester\feature_engineering\test_feature_engineer.py", "Python", 149, 0, 0, 0, 0, 4, 15, 168
"c:\Users\sajit\AlgoRoyale\tests\tests\algo_royale\backtester\optimizer\portfolio\test_portfolio_strategy_optimizer.py", "Python", 75, 0, 0, 0, 0, 2, 19, 96
"c:\Users\sajit\AlgoRoyale\tests\tests\algo_royale\backtester\stage_coordinator\test_data_ingest_stage_coordinator.py", "Python", 243, 0, 0, 0, 0, 5, 43, 291
"c:\Users\sajit\AlgoRoyale\tests\tests\algo_royale\backtester\stage_coordinator\test_feature_engineering_stage_coordinator.py", "Python", 78, 0, 0, 0, 0, 4, 30, 112
"c:\Users\sajit\AlgoRoyale\tests\tests\algo_royale\backtester\stage_coordinator\test_portfolio_optimization_stage_coordinator.py", "Python", 145, 0, 0, 0, 0, 2, 30, 177
"c:\Users\sajit\AlgoRoyale\tests\tests\algo_royale\backtester\stage_coordinator\test_portfolio_testing_stage_coordinator.py", "Python", 157, 0, 0, 0, 0, 4, 30, 191
"c:\Users\sajit\AlgoRoyale\tests\tests\algo_royale\backtester\stage_coordinator\test_strategy_optimization_stage_coordinator.py", "Python", 643, 0, 0, 0, 0, 4, 71, 718
"c:\Users\sajit\AlgoRoyale\tests\tests\algo_royale\backtester\stage_coordinator\test_strategy_testing_stage_coordinator.py", "Python", 380, 0, 0, 0, 0, 6, 55, 441
"c:\Users\sajit\AlgoRoyale\tests\tests\algo_royale\backtester\stage_data\loader\test_stage_data_loader.py", "Python", 113, 0, 0, 0, 0, 13, 24, 150
"c:\Users\sajit\AlgoRoyale\tests\tests\algo_royale\backtester\stage_data\loader\test_symbol_strategy_data_loader.py", "Python", 62, 0, 0, 0, 0, 3, 15, 80
"c:\Users\sajit\AlgoRoyale\tests\tests\algo_royale\backtester\stage_data\test_stage_data_manager.py", "Python", 185, 0, 0, 0, 0, 2, 29, 216
"c:\Users\sajit\AlgoRoyale\tests\tests\algo_royale\backtester\stage_data\writer\test_stage_data_writer.py", "Python", 68, 0, 0, 0, 0, 0, 20, 88
"c:\Users\sajit\AlgoRoyale\tests\tests\algo_royale\backtester\stage_data\writer\test_symbol_strategy_data_writer.py", "Python", 56, 0, 0, 0, 0, 1, 14, 71
"c:\Users\sajit\AlgoRoyale\tests\tests\algo_royale\backtester\strategy\portfolio\test_equal_risk_contribution_portfolio_strategy.py", "Python", 55, 0, 0, 0, 0, 1, 9, 65
"c:\Users\sajit\AlgoRoyale\tests\tests\algo_royale\backtester\strategy\portfolio\test_equal_weight_portfolio_strategy.py", "Python", 25, 0, 0, 0, 0, 4, 4, 33
"c:\Users\sajit\AlgoRoyale\tests\tests\algo_royale\backtester\strategy\portfolio\test_inverse_volatility_portfolio_strategy.py", "Python", 41, 0, 0, 0, 0, 1, 7, 49
"c:\Users\sajit\AlgoRoyale\tests\tests\algo_royale\backtester\strategy\portfolio\test_max_sharpe_portfolio_strategy.py", "Python", 57, 0, 0, 0, 0, 5, 9, 71
"c:\Users\sajit\AlgoRoyale\tests\tests\algo_royale\backtester\strategy\portfolio\test_mean_variance_portfolio_strategy.py", "Python", 57, 0, 0, 0, 0, 1, 9, 67
"c:\Users\sajit\AlgoRoyale\tests\tests\algo_royale\backtester\strategy\portfolio\test_minimum_variance_portfolio_strategy.py", "Python", 55, 0, 0, 0, 0, 1, 9, 65
"c:\Users\sajit\AlgoRoyale\tests\tests\algo_royale\backtester\strategy\portfolio\test_momentum_portfolio_strategy.py", "Python", 35, 0, 0, 0, 0, 0, 7, 42
"c:\Users\sajit\AlgoRoyale\tests\tests\algo_royale\backtester\strategy\portfolio\test_risk_parity_portfolio_strategy.py", "Python", 57, 0, 0, 0, 0, 1, 9, 67
"c:\Users\sajit\AlgoRoyale\tests\tests\algo_royale\backtester\strategy\portfolio\test_volatility_weighted_portfolio_strategy.py", "Python", 42, 0, 0, 0, 0, 1, 7, 50
"c:\Users\sajit\AlgoRoyale\tests\tests\algo_royale\backtester\strategy\portfolio\test_winner_takes_all_portfolio_strategy.py", "Python", 55, 0, 0, 0, 0, 1, 9, 65
"c:\Users\sajit\AlgoRoyale\tests\tests\algo_royale\backtester\strategy\signal\test_stateful_logic.py", "Python", 41, 0, 0, 0, 0, 1, 16, 58
"c:\Users\sajit\AlgoRoyale\tests\tests\algo_royale\backtester\strategy\signal\test_strategy.py", "Python", 97, 0, 0, 0, 0, 1, 23, 121
"c:\Users\sajit\AlgoRoyale\tests\tests\algo_royale\backtester\strategy\signal\test_strategy_condition.py", "Python", 46, 0, 0, 0, 0, 2, 19, 67
"c:\Users\sajit\AlgoRoyale\tests\tests\algo_royale\backtester\strategy_combinator\portfolio\test_base_portfolio_strategy_combinator.py", "Python", 62, 0, 0, 0, 0, 2, 27, 91
"c:\Users\sajit\AlgoRoyale\tests\tests\algo_royale\backtester\strategy_combinator\signal\test_strategy_combinator.py", "Python", 115, 0, 0, 0, 0, 2, 20, 137
"c:\Users\sajit\AlgoRoyale\tests\tests\algo_royale\backtester\test_portfolio_backtest_executor.py", "Python", 163, 0, 0, 0, 0, 1, 19, 183
"c:\Users\sajit\AlgoRoyale\tests\tests\algo_royale\clients\alpaca\alpaca_market_data\test_alpaca_corporate_action_client.py", "Python", 43, 0, 0, 0, 0, 2, 13, 58
"c:\Users\sajit\AlgoRoyale\tests\tests\algo_royale\clients\alpaca\alpaca_market_data\test_alpaca_news_client.py", "Python", 38, 0, 0, 0, 0, 4, 12, 54
"c:\Users\sajit\AlgoRoyale\tests\tests\algo_royale\clients\alpaca\alpaca_market_data\test_alpaca_screener_client.py", "Python", 49, 0, 0, 0, 0, 3, 15, 67
"c:\Users\sajit\AlgoRoyale\tests\tests\algo_royale\clients\alpaca\alpaca_market_data\test_alpaca_stock_client.py", "Python", 249, 0, 0, 0, 0, 41, 66, 356
"c:\Users\sajit\AlgoRoyale\tests\tests\algo_royale\clients\alpaca\alpaca_market_data\test_alpaca_stream_client.py", "Python", 46, 0, 0, 0, 0, 9, 18, 73
"c:\Users\sajit\AlgoRoyale\tests\tests\algo_royale\clients\alpaca\alpaca_trading\test_alpaca_account_client.py", "Python", 97, 0, 0, 0, 0, 2, 14, 113
"c:\Users\sajit\AlgoRoyale\tests\tests\algo_royale\clients\alpaca\alpaca_trading\test_alpaca_asset_client.py", "Python", 65, 0, 0, 0, 0, 4, 14, 83
"c:\Users\sajit\AlgoRoyale\tests\tests\algo_royale\clients\alpaca\alpaca_trading\test_alpaca_calendar_client.py", "Python", 41, 0, 0, 0, 0, 8, 16, 65
"c:\Users\sajit\AlgoRoyale\tests\tests\algo_royale\clients\alpaca\alpaca_trading\test_alpaca_clock_client.py", "Python", 18, 0, 0, 0, 0, 3, 12, 33
"c:\Users\sajit\AlgoRoyale\tests\tests\algo_royale\clients\alpaca\alpaca_trading\test_alpaca_orders_client.py", "Python", 197, 0, 0, 0, 0, 17, 45, 259
"c:\Users\sajit\AlgoRoyale\tests\tests\algo_royale\clients\alpaca\alpaca_trading\test_alpaca_portfolio_client.py", "Python", 34, 0, 0, 0, 0, 3, 13, 50
"c:\Users\sajit\AlgoRoyale\tests\tests\algo_royale\clients\alpaca\alpaca_trading\test_alpaca_positions_client.py", "Python", 86, 0, 0, 0, 0, 5, 17, 108
"c:\Users\sajit\AlgoRoyale\tests\tests\algo_royale\clients\alpaca\alpaca_trading\test_alpaca_watchlist_client.py", "Python", 130, 0, 0, 0, 0, 28, 29, 187
"c:\Users\sajit\AlgoRoyale\tests\tests\algo_royale\clients\db\dao\test_base_dao.py", "Python", 63, 0, 0, 0, 0, 30, 29, 122
"c:\Users\sajit\AlgoRoyale\tests\tests\algo_royale\repo\test_data_stream_session_repo.py", "Python", 97, 0, 0, 0, 0, 0, 16, 113
"c:\Users\sajit\AlgoRoyale\tests\tests\algo_royale\repo\test_enriched_data_repo.py", "Python", 56, 0, 0, 0, 0, 0, 14, 70
"c:\Users\sajit\AlgoRoyale\tests\tests\algo_royale\repo\test_order_repo.py", "Python", 81, 0, 0, 0, 0, 0, 16, 97
"c:\Users\sajit\AlgoRoyale\tests\tests\algo_royale\repo\test_trade_repo.py", "Python", 153, 0, 0, 0, 0, 2, 38, 193
"c:\Users\sajit\AlgoRoyale\tests\tests\algo_royale\repo\test_watchlist_repo.py", "Python", 41, 0, 0, 0, 0, 2, 11, 54
"c:\Users\sajit\AlgoRoyale\tests\tests\algo_royale\services\test_account_cash_service.py", "Python", 49, 0, 0, 0, 0, 4, 16, 69
"c:\Users\sajit\AlgoRoyale\tests\tests\algo_royale\services\test_clock_service.py", "Python", 64, 0, 0, 0, 0, 7, 27, 98
"c:\Users\sajit\AlgoRoyale\tests\tests\algo_royale\services\test_enriched_data_service.py", "Python", 79, 0, 0, 0, 0, 0, 22, 101
"c:\Users\sajit\AlgoRoyale\tests\tests\algo_royale\services\test_ledger_service.py", "Python", 92, 0, 0, 0, 0, 2, 24, 118
"c:\Users\sajit\AlgoRoyale\tests\tests\algo_royale\services\test_order_event_service.py", "Python", 94, 0, 0, 0, 0, 5, 26, 125
"c:\Users\sajit\AlgoRoyale\tests\tests\algo_royale\services\test_order_monitor_service.py", "Python", 20, 0, 0, 0, 0, 0, 6, 26
"c:\Users\sajit\AlgoRoyale\tests\tests\algo_royale\services\test_order_service.py", "Python", 141, 0, 0, 0, 0, 0, 29, 170
"c:\Users\sajit\AlgoRoyale\tests\tests\algo_royale\services\test_positions_service.py", "Python", 103, 0, 0, 0, 0, 1, 27, 131
"c:\Users\sajit\AlgoRoyale\tests\tests\algo_royale\services\test_symbol_service.py", "Python", 42, 0, 0, 0, 0, 0, 18, 60
"c:\Users\sajit\AlgoRoyale\tests\tests\algo_royale\services\test_trades_service.py", "Python", 183, 0, 0, 0, 0, 0, 44, 227
"c:\Users\sajit\AlgoRoyale\tests\tests\optuna\test_optuna.py", "Python", 10, 0, 0, 0, 0, 0, 6, 16
"c:\Users\sajit\AlgoRoyale\utils\generate_src_hierarchy.py", "Python", 18, 0, 0, 0, 0, 2, 4, 24
"c:\Users\sajit\AlgoRoyale\utils\helper.py", "Python", 31, 0, 0, 0, 0, 13, 15, 59
"Total", "-", 36881, 2239, 134, 408, 76, 7585, 6486, 53809